NO ./path_to_the_north_texture
SO ./path_to_the_south_texture
WE ./path_to_the_west_texture
EA ./path_to_the_east_texture

F 240,103,9
C 225,30,255

1
1
1
1
1
11111111111111
1N01
111111111111111111