NO ./path_to_the_north_texture
SO ./path_to_the_south_texture
WE ./path_to_the_west_texture
EA ./path_to_the_east_texture

F 240,103,0
C 225,30,0

1111111111111
1000001000001
1000000000001
1000000000001
1000000000001
1000010100001
1000100010001
110000N000001
1000100010001
1000010100001
1000000000001
1111111111111