NO ./path_to_the_north_texture
SO ./path_to_the_south_texture
WE ./path_to_the_west_texture
EA ./path_to_the_east_texture

F 240,103,0
C 225,30,0

        1111111111111111111111111
        1000000000110000000000001
        1011000001110000000000001
        1001000000000000000000001  
111111111011000001110000000000001
100000000111110001110111111111111
1111011111   10111000000100011111111111111111111
111101111111110111010100100000000000W00000000001
110000001101010111000000100011111111111111111111
1000000000000000D0000001000111
100000000000000011010100100011
10000011111010111110111100111
11111111 1111111 11111111111