NO ./textures/Wall_NO1.xpm
SO ./textures/Wall_SO1.xpm
WE ./textures/Wall_WE1.xpm
EA ./textures/Wall_EA1.xpm

F 240,103,0
C 225,30,0

1111
1E01
1111