NO ./path_to_the_north_texture
SO ./path_to_the_south_texture
WE ./path_to_the_west_texture
EA ./path_to_the_east_texture

F 240,103,0
C 225,30,0

111111111111
100000111011
10000N000001
110000001101
111111111111
