NO ./textures/Wall_NO1.xpm
SO ./textures/Wall_SO1.xpm
WE ./textures/Wall_WE1.xpm
EA ./textures/Wall_EA1.xpm

F 240,103,0
C 225,30,0

        1111111111111111111111111
        1000000000110000000000001
        1011000000100000000000001
        1001000000000000000000001
111111111011000001110000000000001
100000000011100001110111111111111
1111011111   10111000000100011111
111101111111110111010100100011111
11000000110101011100000010001
100000000000000011000000D0101
10000000000000001101010010001
10000011101010111110111100001
11110111 1110101 101111010001
11111111 1111111 111111111111
