NO ./textures/Texture_4_purple_brick.xpm
SO ./textures/Texture_3_purple_brick.xpm
WE ./textures/Texture_2_purple_brick.xpm
EA ./textures/Texture_1_purple_brick.xpm

C 7,37,61
F 3,21,36

        1111111111111111111111111
        1000000000110000000000001
        1011000001110000000000001
        1001000000000000000000001
111111111011000001110000000000001
100000000011000001110111111111111
11110111111111011100000010001
111101111111110111010100D0001
11000000110101011100000010001
100000000000000011000000D0001
10000000000000001101010010N01
1100000111010101111101111000111
11110111 1110101 101111010001
11111111 1111111 111111111111