NO ./textures/3_Building.xpm
SO ./textures/6_Bee.xpm
WE ./textures/1_Square.xpm
EA ./textures/2_Building.xpm

C 44,31,105
F 27,13,54

        1111111111111111111111111
        1000000000110000000000001     1111111
        1011000001110000000000001     1000001 
        1001000000000000000000001     1111111
111111111011000001110000000000001
100000000011000001110111111111111
11110111111111011100000010001
111101111111110111010100D0001
11000000110101011100000010001
10000000000000000D00000010001
10000000000000001101010010N01
11000001110101011111011110001
11110111 1110101 101111010001
11111111 1111111 111111111111