NO ./textures/Texture_1_building.xpm
SO ./textures/Wall_SO1.xpm
WE ./textures/Wall_EA1.xpm
EA ./textures/Texture_17_Building.xpm

C 44,31,105
F 27,13,54

        11111111111111111
        1000000000110001
        1011000001110001111
        100100000000000000111
11111111101100000111011111111
10000000001100000111011111111
11110111111111011100000010001
111101111111110111010100D0001
11000000110101011100000010001
100000000000000011000000D0001
10000000000000001101010010N01
11000001110101011111011110001
11110111 1110101 101111010001
11111111 1111111 111111111111